##################################################
#          #                  #    ###      #    #
#    @                 ###    #            #     #
#                  #   ###          #            #
##   ####################### ################ ####
#          ####           #     #          #     #
#                  ###          #                #
#     ######       ###          #    #           #
#          ####           #          #           #
###  ####################### ############   ###  #
#              #                                 #
#    ########         #                  #########
##################################################